05
08
#####>##
#..B.B.#
#$$...m#
#.$..@.#
########
04
