07
16
#######>########
#.....mmm......#
#.....m*m......#
#..@..mmm...m$m#
#...........m$m#
#..B........m$m#
#############>##
10
